parrot-n	vertebrate-n
alpha-n	symbol-n
pair-n	set-n
multiculturalism-n	doctrine-n
airman-n	worker-n
winger-n	athlete-n
firearm-n	weapon-n
benzene-n	chemical-n
benzene-n	hydrocarbon-n
patience-n	trait-n
immunology-n	science-n
immunology-n	discipline-n
polymer-n	chemical-n
visualization-n	representation-n
bargain-n	agreement-n
grandfather-n	grandparent-n
supercomputer-n	computer-n
supercomputer-n	machine-n
housewife-n	woman-n
prelate-n	clergyman-n
aneurysm-n	disorder-n
prosecutor-n	official-n
strawberry-n	berry-n
sloop-n	vehicle-n
pearl-n	jewel-n
pearl-n	jewelry-n
colt-n	male-n
mangrove-n	tree-n
covenant-n	document-n
oyster-n	animal-n
memo-n	note-n
memo-n	record-n
roadway-n	road-n
cipher-n	message-n
virus-n	microorganism-n
compassion-n	feeling-n
suitcase-n	container-n
histogram-n	chart-n
immigration-n	migration-n
anatomy-n	discipline-n
geology-n	discipline-n
petroleum-n	chemical-n
petroleum-n	oil-n
lion-n	animal-n
lion-n	vertebrate-n
nostalgia-n	feeling-n
melon-n	fruit-n
melon-n	solid-n
initiation-n	ceremony-n
webcam-n	camera-n
symphony-n	music-n
stagecoach-n	vehicle-n
quarterback-n	player-n
dragonfly-n	animal-n
dragonfly-n	insect-n
affection-n	feeling-n
vandalism-n	mischief-n
chimpanzee-n	mammal-n
chimpanzee-n	vertebrate-n
rig-n	equipment-n
cook-n	worker-n
charcoal-n	carbon-n
ticket-n	document-n
bug-n	animal-n
bug-n	invertebrate-n
waiter-n	employee-n
croquet-n	sport-n
croquet-n	game-n
questionnaire-n	document-n
gland-n	organ-n
tour-n	travel-n
calf-n	animal-n
fetus-n	vertebrate-n
gastropod-n	invertebrate-n
pram-n	vehicle-n
rainforest-n	vegetation-n
principle-n	idea-n
pig-n	swine-n
rabbit-n	vertebrate-n
environmentalist-n	reformer-n
teaching-n	occupation-n
artery-n	vessel-n
oncology-n	science-n
oncology-n	discipline-n
compost-n	mixture-n
butterfly-n	animal-n
butterfly-n	insect-n
collagen-n	protein-n
collagen-n	molecule-n
waitress-n	employee-n
waitress-n	worker-n
dinghy-n	boat-n
pew-n	bench-n
nipple-n	organ-n
eel-n	solid-n
shopkeeper-n	merchant-n
locomotive-n	vehicle-n
parent-n	relative-n
antiquity-n	era-n
radiation-n	phenomenon-n
enumeration-n	information-n
enumeration-n	list-n
roster-n	list-n
tsunami-n	wave-n
motorcycle-n	vehicle-n
mailbox-n	container-n
batsman-n	athlete-n
batsman-n	player-n
electrolyte-n	solution-n
salmon-n	animal-n
salmon-n	fish-n
snail-n	animal-n
sedan-n	vehicle-n
sedan-n	car-n
pharmacy-n	discipline-n
skating-n	sport-n
horseman-n	rider-n
crab-n	invertebrate-n
forearm-n	limb-n
horse-n	animal-n
horse-n	mammal-n
horse-n	vertebrate-n
typhoon-n	phenomenon-n
typhoon-n	storm-n
walnut-n	nut-n
fly-n	invertebrate-n
porter-n	workman-n
porter-n	employee-n
porter-n	worker-n
dad-n	relative-n
dad-n	progenitor-n
daddy-n	parent-n
camera-n	equipment-n
limousine-n	vehicle-n
limousine-n	car-n
deer-n	animal-n
deer-n	mammal-n
attorney-n	professional-n
bookmark-n	marker-n
protein-n	molecule-n
spokesman-n	spokesperson-n
license-n	document-n
pennant-n	symbol-n
turret-n	tower-n
woman-n	adult-n
nickname-n	name-n
linguistics-n	science-n
emigrant-n	migrant-n
screwdriver-n	tool-n
resignation-n	feeling-n
crusade-n	undertaking-n
ecstasy-n	feeling-n
ecstasy-n	emotion-n
kindergarten-n	institution-n
chant-n	music-n
automobile-n	vehicle-n
race-n	contest-n
helicopter-n	vehicle-n
clinician-n	professional-n
missile-n	weapon-n
privateer-n	mariner-n
privateer-n	sailor-n
earring-n	decoration-n
spasm-n	symptom-n
acoustics-n	discipline-n
rugby-n	game-n
emigration-n	migration-n
insomnia-n	disorder-n
preposition-n	word-n
reliability-n	trait-n
drizzle-n	rain-n
grove-n	vegetation-n
draft-n	document-n
organist-n	performer-n
chef-n	worker-n
dog-n	carnivore-n
dog-n	mammal-n
jurisprudence-n	discipline-n
final-n	contest-n
competitiveness-n	trait-n
disappointment-n	feeling-n
miner-n	workman-n
cow-n	vertebrate-n
pet-n	animal-n
sack-n	bag-n
gauge-n	instrument-n
orator-n	speaker-n
taste-n	sensation-n
parser-n	software-n
handset-n	equipment-n
passion-n	feeling-n
directorate-n	organization-n
snake-n	animal-n
skier-n	athlete-n
chariot-n	vehicle-n
seaweed-n	alga-n
jewelry-n	decoration-n
charity-n	institution-n
turbine-n	engine-n
pathologist-n	doctor-n
fox-n	animal-n
fox-n	mammal-n
fox-n	vertebrate-n
rhino-n	vertebrate-n
receiver-n	equipment-n
governor-n	politician-n
balloon-n	aircraft-n
lunch-n	meal-n
sociology-n	science-n
maple-n	wood-n
corridor-n	passageway-n
monarch-n	ruler-n
biochemistry-n	science-n
biochemistry-n	chemistry-n
musket-n	gun-n
oil-n	lipid-n
sundial-n	instrument-n
sadness-n	feeling-n
workbook-n	publication-n
comic-n	performer-n
comic-n	entertainer-n
joker-n	performer-n
joker-n	entertainer-n
bureau-n	organization-n
knife-n	tool-n
medication-n	drug-n
aquarium-n	container-n
coaching-n	occupation-n
cat-n	carnivore-n
cat-n	mammal-n
jeweler-n	maker-n
tench-n	animal-n
tench-n	fish-n
parapet-n	wall-n
textbook-n	book-n
golf-n	sport-n
basketball-n	game-n
ferry-n	vehicle-n
ferry-n	boat-n
electrician-n	worker-n
frigate-n	vehicle-n
ambassador-n	diplomat-n
ambassador-n	worker-n
safari-n	travel-n
pseudonym-n	name-n
sulphate-n	chemical-n
motorbike-n	vehicle-n
spaceship-n	vehicle-n
violinist-n	entertainer-n
magistrate-n	official-n
perseverance-n	trait-n
casket-n	container-n
headline-n	text-n
gunboat-n	vehicle-n
gunboat-n	boat-n
carbohydrate-n	molecule-n
aircraft-n	vehicle-n
vocalist-n	performer-n
terror-n	feeling-n
terror-n	emotion-n
binder-n	machine-n
playlist-n	information-n
playlist-n	list-n
berry-n	solid-n
galley-n	vehicle-n
toe-n	extremity-n
orange-n	solid-n
soccer-n	game-n
benzodiazepine-n	drug-n
theology-n	discipline-n
jet-n	vehicle-n
muse-n	deity-n
girlfriend-n	woman-n
phonology-n	science-n
contract-n	statement-n
midwife-n	professional-n
dentistry-n	science-n
dentistry-n	medicine-n
flea-n	invertebrate-n
flea-n	parasite-n
panda-n	animal-n
panda-n	mammal-n
panda-n	vertebrate-n
penis-n	organ-n
adjective-n	word-n
opium-n	narcotic-n
engineering-n	occupation-n
cotton-n	fiber-n
telegraph-n	apparatus-n
investment-n	transaction-n
bingo-n	game-n
oat-n	cereal-n
weapon-n	instrument-n
butcher-n	merchant-n
memorandum-n	note-n
pope-n	leader-n
cradle-n	furniture-n
arithmetic-n	discipline-n
carbonate-n	chemical-n
dynamite-n	explosive-n
crow-n	animal-n
antibiotic-n	drug-n
migrant-n	traveler-n
dolphin-n	animal-n
rectangle-n	polygon-n
dinner-n	meal-n
lemon-n	fruit-n
spear-n	weapon-n
spear-n	instrument-n
marquee-n	tent-n
cage-n	enclosure-n
floor-n	surface-n
karaoke-n	entertainment-n
nerve-n	tissue-n
leak-n	opening-n
kettle-n	utensil-n
kettle-n	container-n
hallway-n	passageway-n
bassist-n	musician-n
bassist-n	entertainer-n
diplomat-n	worker-n
holly-n	tree-n
throne-n	chair-n
bulldog-n	dog-n
worm-n	invertebrate-n
hymn-n	song-n
lipid-n	molecule-n
rain-n	phenomenon-n
silo-n	tower-n
python-n	animal-n
python-n	reptile-n
python-n	vertebrate-n
overpayment-n	payment-n
auto-n	vehicle-n
modifier-n	word-n
rector-n	leader-n
shark-n	fish-n
storyteller-n	communicator-n
carpenter-n	worker-n
football-n	sport-n
football-n	game-n
bamboo-n	wood-n
dancer-n	entertainer-n
condom-n	contraceptive-n
employee-n	worker-n
human-n	vertebrate-n
nurse-n	adult-n
bounty-n	payment-n
brethren-n	organization-n
fairytale-n	narrative-n
beech-n	tree-n
tern-n	vertebrate-n
pony-n	horse-n
pony-n	mammal-n
enzyme-n	molecule-n
descendent-n	relative-n
hockey-n	sport-n
anesthetic-n	drug-n
laptop-n	computer-n
laptop-n	machine-n
envy-n	feeling-n
swimmer-n	athlete-n
scapegoat-n	victim-n
firm-n	business-n
firm-n	organization-n
reservist-n	serviceman-n
saxophonist-n	performer-n
bottle-n	container-n
hurricane-n	storm-n
insect-n	animal-n
monsoon-n	wind-n
logic-n	discipline-n
animosity-n	feeling-n
animosity-n	emotion-n
shellfish-n	solid-n
checklist-n	information-n
checklist-n	list-n
bailiff-n	worker-n
cycling-n	sport-n
convention-n	meeting-n
cassette-n	container-n
toad-n	animal-n
acid-n	chemical-n
relief-n	feeling-n
butter-n	solid-n
nematode-n	invertebrate-n
bib-n	fabric-n
height-n	magnitude-n
height-n	dimension-n
subtraction-n	calculation-n
experiment-n	research-n
parachute-n	equipment-n
cowboy-n	workman-n
salesman-n	employee-n
salesman-n	worker-n
reimbursement-n	compensation-n
reimbursement-n	payment-n
laboratory-n	workplace-n
wife-n	spouse-n
battleship-n	vehicle-n
battleship-n	ship-n
affidavit-n	document-n
subcontractor-n	contractor-n
statesman-n	leader-n
anesthetist-n	adult-n
anesthetist-n	professional-n
seabird-n	bird-n
seabird-n	vertebrate-n
tongue-n	organ-n
armchair-n	chair-n
wader-n	bird-n
wader-n	vertebrate-n
compass-n	instrument-n
bestseller-n	publication-n
rifle-n	weapon-n
goose-n	waterfowl-n
goose-n	vertebrate-n
telescope-n	instrument-n
boar-n	mammal-n
resentment-n	emotion-n
postman-n	worker-n
percussionist-n	performer-n
chicken-n	solid-n
microbiology-n	biology-n
seawater-n	water-n
reggae-n	music-n
investing-n	transaction-n
bowling-n	game-n
fencing-n	obstruction-n
ferret-n	carnivore-n
company-n	institution-n
company-n	organization-n
alga-n	microorganism-n
magpie-n	animal-n
magpie-n	bird-n
heat-n	energy-n
sausage-n	solid-n
wheat-n	cereal-n
cellulose-n	carbohydrate-n
cellulose-n	chemical-n
concerto-n	music-n
eating-n	consumption-n
fallacy-n	idea-n
bitterness-n	feeling-n
bitterness-n	emotion-n
lamb-n	animal-n
puppy-n	mammal-n
puppy-n	vertebrate-n
colon-n	organ-n
cynicism-n	feeling-n
scissors-n	tool-n
pear-n	fruit-n
pear-n	produce-n
intestine-n	organ-n
swimming-n	sport-n
secretariat-n	organization-n
fielder-n	athlete-n
quartz-n	solid-n
stallion-n	animal-n
stallion-n	horse-n
leg-n	limb-n
platter-n	ware-n
badminton-n	sport-n
bee-n	animal-n
bee-n	invertebrate-n
vial-n	container-n
elephant-n	animal-n
propaganda-n	information-n
counterattack-n	attack-n
rainwater-n	water-n
catcher-n	player-n
campsite-n	site-n
nursing-n	work-n
humanism-n	doctrine-n
reelection-n	election-n
fisherman-n	worker-n
mariner-n	worker-n
serpent-n	animal-n
serpent-n	reptile-n
serpent-n	vertebrate-n
racing-n	sport-n
son-n	relative-n
son-n	offspring-n
monoclonal-n	protein-n
monoclonal-n	molecule-n
goldfish-n	vertebrate-n
astronomy-n	science-n
secret-n	information-n
pc-n	computer-n
pc-n	machine-n
spokeswoman-n	spokesperson-n
bird-n	animal-n
turkey-n	animal-n
turkey-n	bird-n
crocodile-n	animal-n
nanny-n	adult-n
vertebrate-n	animal-n
pontoon-n	boat-n
bookshop-n	shop-n
mule-n	animal-n
mule-n	mammal-n
tar-n	chemical-n
chemistry-n	science-n
neuroscience-n	science-n
neuroscience-n	discipline-n
preamble-n	section-n
writer-n	communicator-n
rucksack-n	bag-n
amphetamine-n	drug-n
mother-n	relative-n
stag-n	animal-n
stag-n	mammal-n
wolf-n	carnivore-n
wolf-n	vertebrate-n
poet-n	writer-n
luncheon-n	meal-n
cemetery-n	site-n
elm-n	tree-n
clerk-n	worker-n
wage-n	payment-n
mare-n	animal-n
mare-n	horse-n
mare-n	vertebrate-n
fish-n	animal-n
breeze-n	wind-n
airplane-n	vehicle-n
antibody-n	molecule-n
woodpecker-n	animal-n
woodpecker-n	bird-n
duck-n	bird-n
militia-n	organization-n
zebra-n	animal-n
vicar-n	priest-n
vicar-n	clergyman-n
bead-n	jewelry-n
military-n	organization-n
lactose-n	chemical-n
lactose-n	molecule-n
bridesmaid-n	woman-n
alley-n	thoroughfare-n
symposium-n	meeting-n
handgun-n	gun-n
handgun-n	instrument-n
handgun-n	weapon-n
ant-n	invertebrate-n
ant-n	insect-n
fluorescence-n	phenomenon-n
publisher-n	firm-n
conservatism-n	attitude-n
hysteria-n	disorder-n
plum-n	tree-n
mollusc-n	animal-n
baby-n	offspring-n
racehorse-n	mammal-n
box-n	container-n
seaplane-n	vehicle-n
seaplane-n	airplane-n
maggot-n	larva-n
maggot-n	animal-n
reindeer-n	animal-n
annals-n	periodical-n
buffalo-n	mammal-n
drummer-n	performer-n
drummer-n	entertainer-n
theft-n	felony-n
fullback-n	athlete-n
hare-n	animal-n
hare-n	mammal-n
sir-n	man-n
drift-n	phenomenon-n
baroness-n	aristocrat-n
enzymology-n	science-n
enzymology-n	biochemistry-n
pine-n	tree-n
agony-n	feeling-n
bull-n	animal-n
bull-n	mammal-n
carnage-n	murder-n
footbridge-n	bridge-n
piper-n	musician-n
piper-n	performer-n
piper-n	entertainer-n
longing-n	feeling-n
negation-n	statement-n
autobiography-n	record-n
graveyard-n	site-n
knuckle-n	joint-n
aphid-n	invertebrate-n
aphid-n	insect-n
importation-n	commerce-n
odor-n	sensation-n
depth-n	magnitude-n
fishing-n	sport-n
optimism-n	feeling-n
humanist-n	scholar-n
bat-n	vertebrate-n
gorge-n	valley-n
falsehood-n	statement-n
spouse-n	relative-n
tank-n	vehicle-n
disco-n	music-n
skin-n	tissue-n
bed-n	furniture-n
physician-n	adult-n
physician-n	professional-n
anorexia-n	disorder-n
dogma-n	doctrine-n
fresco-n	art-n
fresco-n	painting-n
empress-n	ruler-n
surgeon-n	professional-n
cutlery-n	tool-n
president-n	leader-n
goalkeeper-n	athlete-n
goalkeeper-n	player-n
studio-n	workplace-n
shortcut-n	road-n
goat-n	mammal-n
pheasant-n	animal-n
pheasant-n	vertebrate-n
peptide-n	chemical-n
generator-n	apparatus-n
shower-n	fixture-n
sprinter-n	athlete-n
apostle-n	believer-n
dramatist-n	writer-n
physiology-n	science-n
pancreas-n	organ-n
cellist-n	performer-n
cellist-n	entertainer-n
foundry-n	plant-n
jealousy-n	feeling-n
supper-n	meal-n
fright-n	emotion-n
bear-n	carnivore-n
bear-n	mammal-n
bear-n	vertebrate-n
biotechnology-n	discipline-n
warrant-n	document-n
golfer-n	player-n
maid-n	servant-n
funeral-n	ceremony-n
cookbook-n	book-n
pharmacology-n	science-n
ox-n	animal-n
freeware-n	software-n
soloist-n	musician-n
soloist-n	performer-n
economics-n	discipline-n
filly-n	female-n
toddler-n	child-n
neurology-n	science-n
chancellor-n	leader-n
noun-n	word-n
glider-n	vehicle-n
glider-n	aircraft-n
medicine-n	discipline-n
objectivity-n	trait-n
apathy-n	feeling-n
artiste-n	performer-n
artiste-n	entertainer-n
gale-n	phenomenon-n
daughter-n	offspring-n
raven-n	vertebrate-n
volleyball-n	sport-n
volleyball-n	game-n
uterus-n	organ-n
pianist-n	entertainer-n
dagger-n	instrument-n
grandchild-n	relative-n
grandchild-n	offspring-n
owl-n	bird-n
owl-n	vertebrate-n
pocket-n	container-n
deafness-n	disability-n
church-n	organization-n
remorse-n	feeling-n
dancing-n	discipline-n
reptile-n	animal-n
reptile-n	vertebrate-n
psychology-n	science-n
vulture-n	vertebrate-n
velvet-n	fabric-n
insecticide-n	pesticide-n
gorilla-n	mammal-n
nanotechnology-n	discipline-n
displeasure-n	emotion-n
royalty-n	payment-n
seminary-n	institution-n
psychotherapy-n	science-n
psychotherapy-n	discipline-n
pigeon-n	vertebrate-n
algebra-n	mathematics-n
algebra-n	science-n
answer-n	statement-n
kangaroo-n	animal-n
kangaroo-n	mammal-n
rodent-n	animal-n
rodent-n	mammal-n
rodent-n	vertebrate-n
malaria-n	infection-n
syringe-n	instrument-n
freeway-n	road-n
man-n	adult-n
kingfisher-n	bird-n
kingfisher-n	vertebrate-n
eagle-n	animal-n
eagle-n	bird-n
eagle-n	vertebrate-n
spacecraft-n	equipment-n
terrier-n	carnivore-n
terrier-n	dog-n
educator-n	professional-n
polymerase-n	chemical-n
polymerase-n	enzyme-n
math-n	science-n
knee-n	joint-n
rider-n	traveler-n
tanker-n	vehicle-n
tanker-n	ship-n
boulevard-n	thoroughfare-n
trolley-n	vehicle-n
highway-n	road-n
dance-n	art-n
hawk-n	animal-n
hawk-n	bird-n
sunlight-n	light-n
mime-n	performer-n
greyhound-n	animal-n
greyhound-n	hound-n
greyhound-n	dog-n
logo-n	symbol-n
dove-n	animal-n
motorway-n	road-n
teacher-n	professional-n
comedian-n	performer-n
prefecture-n	district-n
psychiatry-n	science-n
editorial-n	prose-n
spectrometer-n	instrument-n
bereavement-n	emotion-n
mail-n	message-n
robin-n	animal-n
robin-n	vertebrate-n
granny-n	relative-n
rat-n	mammal-n
husband-n	relative-n
dictionary-n	book-n
cricketer-n	athlete-n
shovel-n	tool-n
geometry-n	science-n
geometry-n	discipline-n
tycoon-n	businessman-n
thesaurus-n	publication-n
postcard-n	mail-n
receptionist-n	worker-n
louse-n	insect-n
pathology-n	science-n
tortoise-n	animal-n
tortoise-n	reptile-n
gent-n	adult-n
surprise-n	feeling-n
infant-n	relative-n
gunner-n	serviceman-n
brigade-n	organization-n
almond-n	tree-n
apple-n	solid-n
love-n	feeling-n
bike-n	vehicle-n
bomber-n	aircraft-n
bomber-n	airplane-n
moth-n	insect-n
hen-n	bird-n
pilgrimage-n	journey-n
pilot-n	worker-n
aesthetic-n	doctrine-n
dish-n	container-n
dinosaur-n	vertebrate-n
lady-n	adult-n
soldier-n	serviceman-n
vole-n	animal-n
vole-n	rodent-n
vole-n	vertebrate-n
cockroach-n	invertebrate-n
cockroach-n	insect-n
trumpeter-n	performer-n
trumpeter-n	entertainer-n
soprano-n	performer-n
soprano-n	singer-n
soprano-n	entertainer-n
biplane-n	vehicle-n
biplane-n	aircraft-n
biplane-n	airplane-n
granddaughter-n	offspring-n
mom-n	parent-n
excitement-n	feeling-n
adrenaline-n	chemical-n
adrenaline-n	neurotransmitter-n
warbler-n	singer-n
thunderstorm-n	storm-n
gasoline-n	fuel-n
gasoline-n	hydrocarbon-n
asp-n	reptile-n
asp-n	snake-n
asp-n	vertebrate-n
encyclopedia-n	book-n
lizard-n	reptile-n
penicillin-n	antibiotic-n
hedgehog-n	rodent-n
hedgehog-n	vertebrate-n
craftsman-n	professional-n
graft-n	tissue-n
housekeeper-n	servant-n
brook-n	stream-n
pouch-n	container-n
invertebrate-n	animal-n
zeal-n	feeling-n
radar-n	instrument-n
blaze-n	combustion-n
manual-n	publication-n
chick-n	animal-n
chick-n	bird-n
chick-n	vertebrate-n
resident-n	inhabitant-n
rage-n	emotion-n
concert-n	performance-n
caucus-n	gathering-n
motorist-n	driver-n
voice-n	sound-n
pronoun-n	word-n
screenwriter-n	writer-n
mistress-n	woman-n
notary-n	official-n
cookie-n	solid-n
dioxin-n	hydrocarbon-n
warship-n	vehicle-n
fork-n	ware-n
anger-n	feeling-n
anger-n	emotion-n
swan-n	bird-n
desk-n	furniture-n
snooker-n	game-n
princess-n	aristocrat-n
preconception-n	belief-n
hamster-n	rodent-n
jigsaw-n	tool-n
jigsaw-n	machine-n
stereo-n	equipment-n
netball-n	game-n
father-n	progenitor-n
army-n	organization-n
cannon-n	armament-n
cannon-n	artillery-n
sis-n	relative-n
fingertip-n	tip-n
frustration-n	feeling-n
archbishop-n	priest-n
archbishop-n	clergyman-n
sweetness-n	sensation-n
cosmology-n	discipline-n
professorship-n	occupation-n
seminar-n	gathering-n
cricket-n	insect-n
song-n	music-n
mortar-n	weaponry-n
telephony-n	telecommunication-n
criminology-n	discipline-n
physiotherapist-n	therapist-n
navy-n	organization-n
yearning-n	feeling-n
electronics-n	science-n
electronics-n	discipline-n
raisin-n	produce-n
basket-n	container-n
aspirin-n	drug-n
facade-n	surface-n
waterfowl-n	animal-n
keyboardist-n	performer-n
technician-n	worker-n
pickup-n	vehicle-n
mucosa-n	tissue-n
squid-n	solid-n
ape-n	animal-n
ape-n	mammal-n
mob-n	crowd-n
mango-n	tree-n
stipend-n	payment-n
penguin-n	animal-n
penguin-n	bird-n
penguin-n	seabird-n
baggage-n	container-n
grandmother-n	grandparent-n
grandmother-n	relative-n
decrease-n	change-n
bacterium-n	microorganism-n
wrath-n	emotion-n
intranet-n	system-n
baritone-n	singer-n
baritone-n	entertainer-n
documentary-n	movie-n
kestrel-n	animal-n
kestrel-n	vertebrate-n
vertex-n	point-n
islander-n	inhabitant-n
tyrant-n	ruler-n
sawmill-n	machine-n
complacency-n	feeling-n
retina-n	tissue-n
desire-n	feeling-n
buggy-n	vehicle-n
buggy-n	container-n
